ffffffffffffff
ffF0f0g0f0f5ff
ffF0cfb0f0f0ff
ffg0b0m0b0g0ff
fff0f0b0f0F0ff
fff0f0g0f0F0ff
ffffffffffffff